wwwwwwwww
wp000000w
w0w0w0w0w
w0000000w
w0w0w0w0w
w0000000w
w0w0w0w0w
w0000000w
wwwwwwwww